R 800 600
NO ./textures/no.xpm
SO ./textures/so.xpm
WE ./textures/we.xpm
EA ./textures/ea.xpm
S ./textures/barrel.xpm
F 189,236,182
C 135,206,235
1111111111111111111111111
1000000000110000000000001
1011000000110000000000001
10010000000000000000000011111
11111111101100000111000010001
100000000011000001110111100011111
11110111111111011100000010201
11110111111111011101000000201
11000000110101011100000000201
10000000000000001100000010201
10000000000000001101010010001
11000001110101011111011110N0111
11110111 1110101 101111010001
11111111 1111111 111111111111
